111111111111111111111111111111
1P001110C000000111111000000111
11000100000000001111000CC00011
10000000000000000111000CC00001
1000000000000C0000010000000001
100000011000000000000001111C01
10C000111110000000000111110001
1000011111111000E0001111000001
100000011111000000011100C01111
100C00001100000000001100000111
100000001000011111000110000111
100110000000001111100011000011
100011000000C0011100000110C011
1C00000000000000000C0000000001
111111111111111111111111111111
