1111111111111
100100C000001
1000011111001
1P0011C1000E1
1111111111111