11111111111111111111111
10000000001P10000000001
10111111101C10111111101
10000000001E10000000001
11111111111111111111111
